30
9
22 00 00 00 00 00 00 00 00 00 00 00 00 00 00 00 00 00 00 00 00 00 00 00 00 00 00 00 00 00
27 00 00 00 00 00 00 00 00 00 00 00 00 00 00 00 00 00 00 00 00 00 00 00 00 00 00 00 00 21
27 00 00 00 00 00 00 00 00 00 00 00 00 00 00 00 00 00 00 00 00 00 00 00 00 00 00 00 00 31
27 00 00 00 00 00 00 00 00 00 00 00 00 00 00 00 00 00 00 00 00 21 23 22 00 00 00 00 00 31
27 00 00 00 00 00 00 00 00 00 00 24 26 00 00 00 00 24 26 00 00 31 28 27 00 00 00 00 00 31
27 00 00 00 00 00 00 00 00 00 00 00 00 00 00 00 00 00 00 00 00 31 28 27 00 00 00 00 00 31
27 00 24 25 25 26 00 00 00 00 21 23 23 23 22 00 00 00 00 00 00 31 28 27 00 00 00 00 00 31
27 00 00 00 00 00 00 00 00 00 31 28 28 28 27 00 00 00 00 00 00 31 28 27 00 00 00 00 00 31
29 23 23 23 23 23 23 23 23 23 30 28 28 28 29 23 23 23 23 23 23 30 28 29 23 23 23 23 23 30